x=坐标x
y=坐标y
z=坐标z
distance=距离[仅Java版]
r=最大半径
rm=最小半径
scores=记分项分数
tag=记分板标签
team=队伍名称[仅Java版]
name=实体名称
type=实体类型
family=族
predicate=谓词[仅Java版]
x_rotation=垂直旋转角度[仅Java版]
rx=垂直旋转角度
rxm=垂直旋转角度
y_rotation=水平旋转角度[仅Java版]
ry=水平旋转角度
rym=水平旋转角度
nbt=实体的NBT标签[仅Java版]
hasitem=物品
level=经验等级[仅Java版]
l=最大经验
lm=最小经验
gamemode=游戏模式[仅Java版]
m=游戏模式
advancements=进度[仅Java版]
haspermission=权限
limit=数量[仅Java版]
sort=数量[仅Java版]
c=数量